600,720,
20,24,

0,0,0,0,0,0,0,0,0,2,0,0,0,0,0,0,0,0,0,0,
0,0,0,0,0,0,0,2,0,2,0,9,0,0,0,0,0,0,0,0,
0,0,0,0,0,0,2,2,1,2,2,0,0,0,0,0,0,0,0,0,
0,0,0,0,0,0,0,0,0,2,0,0,0,0,0,0,0,0,0,0,
0,0,0,7,0,0,0,0,0,2,0,0,0,0,0,2,0,0,0,0,
0,9,0,2,0,0,0,0,0,0,0,0,0,0,0,2,0,2,0,0,
0,0,0,2,2,0,0,0,0,0,0,0,0,0,0,2,2,2,0,0,
0,0,0,0,0,0,0,0,0,0,7,0,0,0,0,0,8,0,0,0,
0,0,0,0,0,0,0,0,0,0,2,0,0,0,0,0,0,0,0,0,
0,0,0,0,0,0,0,0,0,0,2,0,9,0,0,0,0,0,0,0,
0,2,0,0,0,0,0,0,0,0,2,0,0,0,0,0,0,0,0,0,
0,8,2,2,0,0,0,0,0,0,0,0,0,0,2,0,0,0,0,0,
0,0,0,0,0,0,0,0,0,0,0,0,0,2,7,2,2,0,0,0,
0,0,0,0,0,0,0,0,0,0,0,0,0,0,0,0,0,0,0,0,
0,0,0,0,0,0,0,0,0,0,0,0,0,0,9,0,0,0,0,0,
0,0,0,0,7,0,0,0,0,0,0,0,0,0,0,0,2,0,0,0,
0,0,0,0,2,2,2,0,0,0,0,0,0,0,0,0,2,0,0,0,
0,0,0,0,0,0,0,0,0,0,0,0,0,0,0,0,2,0,0,0,
0,0,0,0,9,0,0,0,0,0,0,0,0,0,0,0,8,0,0,0,
0,0,0,0,0,0,0,0,0,0,0,0,0,0,0,0,0,0,0,0,
0,0,0,0,0,0,0,0,0,0,0,0,0,0,0,0,0,0,0,0,
0,0,0,2,2,0,0,0,0,0,0,0,0,0,0,0,0,0,0,0,
0,0,0,0,0,0,0,0,0,0,0,0,0,7,2,2,0,0,0,0,
0,0,0,0,0,0,0,0,0,0,0,0,0,0,0,0,0,0,0,0,